10 5
##########
#        #
#   C  # #
#        #
##########
