25 9
#########################
#        #    # S  SSSSS#
#   C #S   #      #SSSSS#
#S       # S   ## #SSSSS#
############## ##########
#  #   S #   #    #      
# W          #  S #      
#  #   S #   S    #      
###################      
