10 5
##########
#        #
#   C #S #
#        #
##########
