level 2: watch out
12 7 0.75
i##i##i.....
#C    #.....
#     ######
i     S   <#
#     ######
#     #.....
i##i##i.....
