level 4: run!
20 20 0.75
####################
#W         #      <#
#          # #######
#C         #       #
#          ####### #
#          #       #
#          #  ######
#          #       #
#          #       #
#          #       #
#          #       #
#          ######  #
#                  #
#                  #
#                  #
#                  #
#                  #
#                  #
#                  #
####################
