10 9
##########
#        #
#   C #S #
#        #
####  ####
#        #
# SSS  S #
#        #
##########
