25 9
#########################
#        #    # S  SSSSS#
#   C #S   #      #SSSSS#
#S       # S   ## #SSSSS#
#####i######## ##########
#  #   S #   #    #      
# W          #  S #      
#  #   S #   S    #      
#####i#############      
