,,,,,,,,,,,,,,|          |,,,,,,,,,,,,,,
,,,,,,,,,,,,,,|          |,,,,,,,,,,,,,,
,,,,,,,,,,,,,,|          |,,,,,,,,,,,,,,
,,,,,,,,,,,,,,|          |,,,,,,,,,,,,,,
,,,,,,,,,,,,,,|          |,,,,,,,,,,,,,,
,,,,,,,,,,,,,,|          |,,,,,,,,,,,,,,
,,,,,,,,,,,,,,|          |,,,,,,,,,,,,,,
,,,,,,,,,,,,,,|          |,,,,,,,,,,,,,,
,,,,,,,,,,,,,,|          |,,,,,,,,,,,,,,
,,,,,,,,,,,,,,#..........#,,,,,,,,,,,,,,
,,,,,,,,,,,,,,,,,,,,,,,,,,,,,,,,,,,,,,,,
,,,,,,,,,,,,,,,,,,,,,,,,,,,,,,,,,,,,,,,,
,,,,,,,,,,,,,,,,,,,,,,,,,,,,,,,,,,,,,,,,
,,,,,,,,,,,,,,,,,,,,,,,,,,,,,,,,,,,,,,,,
,,,,,,,,,,,,,,,,,,,,,,,,,,,,,,,,,,,,,,,,
,,,,,,,,,,,,,,,,,,,,,,,,,,,,,,,,,,,,,,,,
,,,,,,,,,,,,,,,,,,,,,,,,,,,,,,,,,,,,,,,,
,,,,,,,,,,,,,,,,,,,,,,,,,,,,,,,,,,,,,,,,
,,,,,,,,,,,,,,,,,,,,,,,,,,,,,,,,,,,,,,,,
,,,,,,,,,,,,,,,,,,,,,,,,,,,,,,,,,,,,,,,,
