|######################################|
|......................................|
|......................................|
|......................................|
|......................................|
|......................................|
|......................................|
|......................................|
|......................................|
|......................................|
|...............||||||||...............|
|...............||||||||...............|
|...............|||..|||...............|
#####|..........|||..|||..........|#####
     |%%%%%%%%%%|||..|||%%%%%%%%%%|     
     |%%%%%%%%%%##!..!##%%%%%%%%%%|     
     |######!..............!######|     
     |..........|##..##|..........|     
     |..........|%%%%%%|..........|     
     |......|...|%%%%%%|...|......|     
     |......|...|%%%%%%|...|......|     
     |......|...|%%%%%%|...|......|     
     |......|...|%%%%%%|...|......|     
|#####...!###...##!..!##...###!...#####|
|%%%%%............................%%%%%|
|%%%%%............................%%%%%|
|%%%%%............................%%%%%|
|%%%%%............................%%%%%|
|%%%%%............................%%%%%|
##################%%%%##################
,,,,,,,,,,,,,,|%%%%%%%%%%|,,,,,,,,,,,,,,
             ,|%%%%%%%%%%|,             
             ,|%%%%%%%%%%|,             
             ,|%%%%%%%%%%|,             
             ,|%%%%%%%%%%|,             
             ,|%%%%%%%%%%|,             
             ,|%%%%%%%%%%|,             
             ,|%%%%%%%%%%|,             
             ,|%%%%%%%%%%|,             
             ,####!..!####,             
