10 10 0.8
###i  ####
#        #
# W      #
#        i
          
          
i        #
#        #
#        #
####  i###
