10 10 0.8 1
###i..i###
#........#
#.W......#
i........i
..........
..........
i........i
#........#
#........#
###i..i###
